XXXXXXXXXXXXXX
X            X
X XXXXXXXXXX X
X            X
XXXXXXXXXXXXXX
