..............
.SXXXXXXXXXXG.
.            .
.            .
.            .
..............
